23
17
44444444444444444444444
40000000000000000000004
40200000000000000000004
40000000000001111000004
40000000000001111000004
40000000000001111000004
40000000000001111000004
41111111111111111000004				
41111111111111111000004
40011110000000000000004
40011110000000000000004
40011110000111111111114
40000000000000000000004
40000000000000010000034
40011111111111111111114
45555555555555555555554
44444444444444444444444